我慢汁	がまん汁
流石	さすが
滅茶苦茶	めちゃくちゃ
イジワル	いじわる
意地悪	いじわる
非モテ	モテない

//↓可用于译前统一
おちんちん	オチンポ
オチンチン	オチンポ
おちんこ	オチンポ
おちんぽ	オチンポ
おチンポ	オチンポ
雄チンポ	オチンポ
ちんちん	オチンポ
ちんこ	オチンポ
ちんぽ	オチンポ
チンチン	オチンポ
おちんぽ	オチンポ
チンポ	オチンポ
オオチンポ	オチンポ
おオチンポ	オチンポ

オマンコ	おまんこ
マンコ	おまんこ
おおまんこ	おまんこ

アヌス	肛門
アナル	肛門

ザーメン	精液